############################
#............##............#
#f####.#####.##.#####.####o#
#.####.#####.##.#####.####.#
#.####.#####.##.#####.####.#
#..........................#
#.####.##.########.##.####.#
#.####.##.########.##.####.#
#......##....##....##......#
###### ##### ## ##### ######
     # ##### ## ##### #
     # ##          ## #
     # ## ###  ### ## #
###### ## #      # ## ######
          #      #
###### ## #      # ## ######
     # ## ######## ## #
     # ##          ## #
     # ## ######## ## #
###### ## ######## ## ######
#............##............#
#.####.#####.##.#####.####.#
#.####.#####.##.#####.####.#
#...##.........p......##...#
###.##.##.########.##.##.###
###.##.##.########.##.##.###
#......##....##....##......#
#.##########.##.##########.#
#.##########.##.##########.#
#..........................#
############################
