########
#p     #
# ## # #
#      #
# # ####
# # ####
#      #
########