############################
#            ##            #
# #### ##### ## ##### #### #
# #### ##### ## ##### #### #
#                          #
# #### ## ######## ## #### #
# #### ## ######## ## #### #
#      ##    ##    ##      #
###### ##### ## ##### ######
     # ##### ## ##### #
     # ##         ##  #
     # ## ##   ## ##  #
###### ## #     # ##  ######
          #     #          
###### ## #     # ## #######
     # ## ####### ## #
     # ##         ## #
     # ## ####### ## #
###### ## ####### ## #######
#            ##            #
# #### ##### ## ##### #### #
# #### ##### ## ##### #### #
#   ##       p     ##      #
### ## ## ######## ## ## ###
### ## ## ######## ## ## ###
#      ##    ##    ##      #
#  ### ## ## ## ## ## ###  #
#    #    ## ## ##    #    #
# ########## ## ########## #
#                          #
############################
