############################
#             p            #
# ########## ## ########## #
#                          #
############################
